7/10
WWWWWWWWWW
W        W
W WW WWW W
W EW W   W
WWWW WWW W
WPV  WD  W
WIWWWWWWWW